MAP_WIDTH: 49
MAP_HEIGHT: 35
1 0 0 0 0 0 0 1 1 0 0 0 0 0 0 1 1 0 0 0 0 0 0 1 1 0 0 0 0 0 0 1 1 0 0 0 0 0 0 1 1 0 0 0 0 0 0 0 1 
1 0 0 0 0 0 0 1 1 0 0 0 0 0 0 1 1 0 0 0 0 0 0 1 1 0 0 0 0 0 0 1 1 0 0 0 0 0 0 1 1 0 0 0 0 0 0 0 1 
1 0 0 0 0 0 0 1 1 0 0 0 0 0 0 1 1 0 0 0 0 0 0 1 1 0 0 0 0 0 0 1 1 0 0 0 0 0 0 1 1 0 0 0 0 0 0 0 1 
1 0 0 0 0 0 0 1 1 0 0 0 0 0 0 1 1 0 0 0 0 0 0 1 1 0 0 0 0 0 0 1 1 0 0 0 0 0 0 1 1 0 0 0 0 0 0 0 1 
1 0 0 0 0 0 4 1 1 4 0 0 0 0 4 1 1 4 0 0 0 0 4 1 1 4 0 0 0 0 4 1 1 4 0 0 0 0 4 1 1 4 0 0 0 0 0 0 1 
1 3 0 0 0 0 0 1 1 0 0 0 0 0 0 1 1 0 0 0 0 0 0 1 1 0 0 0 0 0 0 1 1 0 0 0 0 0 0 1 1 0 0 0 0 0 0 3 1 
1 0 0 0 0 0 0 0 0 0 0 0 0 0 0 0 0 0 0 0 0 0 0 1 1 0 0 0 0 0 0 0 0 0 0 0 0 0 0 0 0 0 0 0 0 0 0 0 1 
1 3 0 0 0 0 0 0 0 0 0 0 0 0 0 0 0 0 0 0 0 0 0 1 1 0 0 0 0 0 0 0 0 0 0 0 0 0 0 0 0 0 0 0 0 0 0 3 1 
1 0 0 0 0 0 0 0 0 0 0 0 0 0 0 0 0 0 0 0 0 0 0 0 0 0 0 0 0 0 0 0 0 0 0 0 0 0 0 0 0 0 0 0 0 0 0 0 1 
5 2 0 0 0 0 0 0 0 0 0 0 0 0 0 0 0 0 0 0 0 0 0 0 0 0 0 0 0 0 0 0 0 0 0 0 0 0 0 0 0 0 0 0 0 0 0 3 1 
6 2 0 0 0 0 0 0 0 0 0 0 0 0 0 0 0 0 0 0 0 0 0 0 0 0 0 0 0 0 0 0 0 0 0 0 0 0 0 0 0 0 0 0 0 0 0 0 1 
7 2 0 0 0 0 0 0 0 0 0 0 0 0 0 0 0 0 0 0 0 0 0 0 0 0 0 0 0 0 0 0 0 0 0 0 0 0 0 0 0 0 0 0 0 0 0 2 8 
9 2 0 0 0 0 0 0 0 0 0 0 0 0 0 0 0 0 0 0 0 0 0 0 0 0 0 0 0 0 0 0 0 0 0 0 0 0 0 0 0 0 0 0 0 0 0 2 10 
11 2 0 0 0 0 0 0 0 0 0 0 0 0 0 3 0 3 0 0 0 0 0 0 0 0 0 0 0 0 0 0 0 3 0 3 0 0 0 0 0 0 0 0 0 0 0 2 12 
13 2 0 0 0 0 0 0 0 0 0 0 0 0 0 0 0 0 0 0 0 0 0 0 0 0 0 0 0 0 0 0 0 0 0 0 0 0 0 0 0 0 0 0 0 0 0 2 14 
15 2 0 0 0 0 0 0 0 0 0 0 1 1 1 1 1 1 1 0 0 0 0 0 0 0 0 0 0 0 1 1 1 1 1 1 1 0 0 0 0 0 0 0 0 0 0 2 16 
17 2 0 0 0 0 0 0 0 0 0 2 18 1 1 1 1 1 19 2 0 0 0 0 0 0 0 0 0 2 20 1 1 1 1 1 21 2 0 0 0 0 0 0 0 0 0 2 22 
23 2 0 0 0 0 0 0 0 0 0 2 24 1 1 1 1 1 25 2 0 0 0 0 0 0 0 0 0 2 26 1 1 1 1 1 27 2 0 0 0 0 0 0 0 0 0 2 28 
29 2 0 0 0 0 0 0 0 0 0 2 30 1 1 1 1 1 31 2 0 0 0 0 0 0 0 0 0 2 32 1 1 1 1 1 33 2 0 0 0 0 0 0 0 0 0 2 34 
35 2 0 0 0 0 0 0 0 0 0 2 36 1 1 1 1 1 37 2 0 0 0 0 0 0 0 0 0 2 38 1 1 1 1 1 39 2 0 0 0 0 0 0 0 0 0 2 40 
41 2 0 0 0 0 0 0 0 0 0 2 42 1 1 1 1 1 43 2 0 0 0 1 0 0 0 0 0 2 44 1 1 1 1 1 45 2 0 0 0 0 0 0 0 0 0 2 46 
47 2 0 0 0 0 0 0 0 0 0 2 48 1 1 1 1 1 49 2 0 0 0 1 0 0 0 0 0 2 50 1 1 1 1 1 51 2 0 0 0 0 0 0 0 0 0 2 52 
53 2 0 0 0 0 0 0 0 0 0 2 54 1 1 1 1 1 55 2 0 0 0 0 0 0 0 0 0 2 56 1 1 1 1 1 57 2 0 0 0 0 0 0 0 0 0 2 58 
59 2 0 0 0 0 0 0 0 0 0 2 60 1 1 1 1 1 61 2 0 0 0 0 0 0 0 0 0 2 62 1 1 1 1 1 63 2 0 0 0 0 0 0 0 0 0 2 64 
65 2 0 0 0 0 0 0 0 0 0 2 66 1 1 1 1 1 67 2 0 0 0 0 0 0 0 0 0 2 68 1 1 1 1 1 69 2 0 0 0 0 0 0 0 0 0 2 70 
71 2 0 0 0 0 0 0 0 0 0 2 72 1 1 1 1 1 73 2 0 0 0 0 0 0 0 0 0 2 74 1 1 1 1 1 75 2 0 0 0 0 0 0 0 0 0 2 76 
77 2 0 0 0 0 0 0 0 0 0 2 78 1 1 1 1 1 79 2 0 0 0 0 0 0 0 0 0 2 80 1 1 1 1 1 81 2 0 0 0 0 0 0 0 0 0 2 82 
83 2 0 0 0 0 0 0 0 0 0 2 84 1 1 1 1 1 85 2 0 0 0 0 0 0 0 0 0 2 86 1 1 1 1 1 87 2 0 0 0 0 0 0 0 0 0 2 88 
89 2 0 0 0 0 0 0 0 0 0 2 90 1 1 1 1 1 91 2 0 0 0 0 0 0 0 0 0 2 92 1 1 1 1 1 93 2 0 0 0 0 0 0 0 0 0 2 94 
95 2 0 0 0 0 0 0 0 0 0 2 96 1 1 1 1 1 97 2 0 0 0 0 0 0 0 0 0 2 98 1 1 1 1 1 99 2 0 0 0 0 0 0 0 0 0 2 100 
101 2 0 0 0 0 0 0 0 0 0 2 102 1 1 1 1 1 103 2 0 0 0 0 0 0 0 0 0 2 104 1 1 1 1 1 105 2 0 0 0 0 0 0 0 0 0 2 106 
107 2 0 0 0 0 0 0 0 0 0 2 108 1 1 1 1 1 109 2 0 0 0 0 0 0 0 0 0 2 110 1 1 1 1 1 111 2 0 0 0 0 0 0 0 0 0 2 112 
113 2 0 0 0 0 0 0 0 0 0 2 114 1 1 1 1 1 115 2 0 0 0 0 0 0 0 0 0 2 116 1 1 1 1 1 117 2 0 0 0 0 0 0 0 0 0 2 118 
1 0 2 2 2 2 2 2 2 2 2 2 119 1 1 1 1 1 120 2 2 2 2 0 0 2 2 2 2 2 121 1 1 1 1 1 122 2 2 2 2 2 2 2 2 2 2 2 123 
1 1 124 125 126 127 128 129 130 131 132 1 1 1 1 1 1 1 1 1 133 134 135 1 1 136 137 138 139 1 1 1 1 1 1 1 1 1 140 141 142 143 144 145 146 147 148 1 1 
